12 12
0 0
2 2 2 2 2 2 2 2 2 2 2 2
8 8 8 8 8 8 8 8 8 8 8 8
9 9 9 9 9 9 9 9 9 9 9 9
10 10 10 10 10 10 10 10 10 10 10 10
10 10 10 10 10 10 10 10 10 10 10 10
10 10 10 10 10 10 10 10 10 10 10 10
10 10 10 10 10 10 10 10 10 10 10 10
10 10 10 10 10 10 10 10 10 10 10 10
0 0 0 0 0 0 0 1 1 1 1 1
3 3 3 3 3 3 3 3 6 6 6 6
4 4 4 4 4 4 4 4 4 7 7 7
5 5 5 5 5 5 5 5 5 5 5 5